Sr,Zip Code,City,State,Population,Male,Female,Area,Density
1,79936,EL PASO,TX,114734,56170,58564,26.74,4291
2,60629,CHICAGO,IL,113833,54974,58859,6.81,16713
3,11368,CORONA,NY,107962,58332,49630,2.63,41019
4,90650,NORWALK,CA,105940,52844,53096,9.81,10801
5,11220,BROOKLYN,NY,103089,53376,49713,1.79,57559
6,90201,BELL GARDENS,CA,101932,51794,50138,5.94,17172
7,90011,LOS ANGELES,CA,100882,50624,50258,4.29,23538
8,91331,PACOIMA,CA,100535,50338,50197,8.85,11356
9,11385,RIDGEWOOD,NY,99379,49011,50368,3.61,27506
10,77084,HOUSTON,TX,99266,48936,50330,30.75,3229
11,11373,ELMHURST,NY,99159,50558,48601,1.53,64937
12,10467,BRONX,NY,98754,46656,52098,2.33,42384
13,92335,FONTANA,CA,98460,49857,48603,17.33,5682
14,11226,BROOKLYN,NY,98325,44409,53916,1.29,76280
15,60618,CHICAGO,IL,97413,48941,48472,5.06,19248
16,10025,NEW YORK,NY,97390,43572,53818,0.75,129508
17,11236,BROOKLYN,NY,97217,43496,53721,3.6,27042
18,11219,BROOKLYN,NY,96971,48925,48046,1.48,65433
19,77449,KATY,TX,95615,47212,48403,29.89,3199
20,90280,SOUTH GATE,CA,95000,46711,48289,7.31,13005
21,11234,BROOKLYN,NY,94259,44198,50061,7.55,12490
22,90250,HAWTHORNE,CA,93994,45623,48371,6.7,14039
23,11211,BROOKLYN,NY,93271,46187,47084,2.3,40588
24,11208,BROOKLYN,NY,93107,43320,49787,3.46,26941
25,90805,LONG BEACH,CA,92991,45335,47656,7.37,12619
26,8701,LAKEWOOD,NJ,92586,46211,46375,24.59,3765
27,11207,BROOKLYN,NY,92491,41316,51175,2.67,34628
28,60639,CHICAGO,IL,91934,45428,46506,4.88,18851
29,92503,RIVERSIDE,CA,90989,45342,45647,29.87,3046
30,60632,CHICAGO,IL,90845,46337,44508,7.43,12232
31,92683,WESTMINSTER,CA,90640,45221,45419,10,9065
32,92336,FONTANA,CA,90633,44854,45779,24.87,3644
33,78521,BROWNSVILLE,TX,90446,42404,48042,93.14,971
34,75052,GRAND PRAIRIE,TX,89743,43616,46127,26.16,3431
35,91342,SYLMAR,CA,89686,44709,44977,55.1,1628
36,10456,BRONX,NY,87723,41312,46411,1.02,86172
37,90044,LOS ANGELES,CA,87590,41812,45778,5.14,17051
38,10314,STATEN ISLAND,NY,87276,41432,45844,13.72,6364
39,92704,SANTA ANA,CA,87208,43129,44079,7.39,11794
40,60647,CHICAGO,IL,87146,44219,42927,4.05,21533
41,11377,WOODSIDE,NY,86316,43070,43246,2.55,33889
42,94565,PITTSBURG,CA,86204,41968,44236,30.2,2855
43,60623,CHICAGO,IL,85158,42223,42935,5.36,15900
44,92376,RIALTO,CA,84699,42306,42393,13.52,6266
45,91744,LA PUENTE,CA,84674,42681,41993,8.79,9633
46,92804,ANAHEIM,CA,84648,41777,42871,7.01,12084
47,11212,BROOKLYN,NY,84520,34878,49642,1.54,54954
48,11230,BROOKLYN,NY,84219,40774,43445,1.84,45771
49,92154,SAN DIEGO,CA,84060,42972,41088,36.96,2274
50,60804,CICERO,IL,84042,42625,41417,7.66,10966
51,30043,LAWRENCEVILLE,GA,83855,41590,42265,32.53,2578
52,60617,CHICAGO,IL,83435,38290,45145,13.87,6018
53,11355,FLUSHING,NY,83221,39595,43626,1.74,47966
54,11214,BROOKLYN,NY,83156,40527,42629,2.19,38058
55,95076,WATSONVILLE,CA,82930,41387,41543,136.6,607
56,94112,SAN FRANCISCO,CA,82726,41115,41611,3.36,24592
57,75217,DALLAS,TX,82664,41341,41323,27.32,3025
58,93307,BAKERSFIELD,CA,82472,40705,41767,138.9,594
59,10002,NEW YORK,NY,82191,39802,42389,0.88,93505
60,37013,ANTIOCH,TN,81944,38998,42946,40.19,2039
61,91911,CHULA VISTA,CA,81872,39032,42840,11.71,6990
62,30044,LAWRENCEVILLE,GA,81764,40421,41343,24.49,3339
63,93033,OXNARD,CA,81644,41970,39674,29.33,2784
64,91710,CHINO,CA,81596,43328,38268,21.51,3794
65,11206,BROOKLYN,NY,81525,39562,41963,1.43,56851
66,11221,BROOKLYN,NY,81321,37745,43576,1.38,58800
67,11229,BROOKLYN,NY,81030,38425,42605,2.17,37393
68,11204,BROOKLYN,NY,80963,40426,40537,1.59,50952
69,92345,HESPERIA,CA,80683,40676,40007,82.02,984
70,10453,BRONX,NY,79793,37659,42134,0.92,87110
71,93722,FRESNO,CA,79727,39446,40281,19.59,4070
72,11203,BROOKLYN,NY,79572,35351,44221,2.15,37079
73,60625,CHICAGO,IL,78966,40531,38435,3.9,20263
74,75070,MCKINNEY,TX,78837,38821,40016,23.93,3295
75,60608,CHICAGO,IL,78794,43861,34933,6.35,12405
76,79912,EL PASO,TX,78697,38687,40010,23.55,3341
77,77479,SUGAR LAND,TX,78289,38756,39533,33.06,2368
78,92509,RIVERSIDE,CA,78117,39397,38720,31.09,2512
79,92126,SAN DIEGO,CA,77860,40716,37144,12.67,6145
80,10029,NEW YORK,NY,77454,36560,40894,0.83,93884
81,37211,NASHVILLE,TN,77379,39356,38023,21.37,3621
82,10462,BRONX,NY,77369,36156,41213,1.48,52276
83,91910,CHULA VISTA,CA,77320,38164,39156,12.23,6321
84,91706,BALDWIN PARK,CA,77192,38847,38345,13.44,5745
85,90706,BELLFLOWER,CA,76989,37219,39770,6.11,12605
86,90255,HUNTINGTON PARK,CA,76620,38335,38285,3.72,20608
87,91335,RESEDA,CA,76616,37496,39120,6.57,11670
88,94544,HAYWARD,CA,76542,37966,38576,10.96,6986
89,93257,PORTERVILLE,CA,76470,38481,37989,445,172
90,19120,PHILADELPHIA,PA,76430,36133,40297,3.4,22453
91,66062,OLATHE,KS,75938,37476,38462,47.77,1590
92,87121,ALBUQUERQUE,NM,75581,37201,38380,255.97,295
93,91709,CHINO HILLS,CA,75551,37240,38311,34.18,2211
94,75034,FRISCO,TX,75490,37587,37903,50.01,1510
95,78660,PFLUGERVILLE,TX,75038,36121,38917,45.3,1657
96,92553,MORENO VALLEY,CA,75024,36348,38676,10.13,7405
97,10452,BRONX,NY,74931,35135,39796,0.99,76072
98,10458,BRONX,NY,74859,35375,39484,1.01,74191
99,77584,PEARLAND,TX,74761,35894,38867,32.09,2330
100,11218,BROOKLYN,NY,74758,36514,38244,1.43,52352
101,96797,WAIPAHU,HI,74752,37220,37532,34.41,2173
102,22193,WOODBRIDGE,VA,74742,37310,37432,17.68,4229
103,28269,CHARLOTTE,NC,74667,35864,38803,30.43,2454
104,11235,BROOKLYN,NY,74630,34695,39935,2.25,33228
105,11223,BROOKLYN,NY,74606,35957,38649,2.07,35972
106,93550,PALMDALE,CA,74561,36660,37901,196.17,380
107,77429,CYPRESS,TX,74313,36869,37444,38.38,1936
108,95823,SACRAMENTO,CA,74154,35264,38890,11.8,6282
109,78572,MISSION,TX,73998,36245,37753,77.53,954
110,33012,HIALEAH,FL,73805,34817,38988,5.86,12588
111,77573,LEAGUE CITY,TX,73615,36968,36647,30.17,2440
112,93535,LANCASTER,CA,73606,35229,38377,257.9,285
113,75211,DALLAS,TX,73530,37192,36338,17.62,4172
114,60620,CHICAGO,IL,73253,32169,41084,7.09,10336
115,85364,YUMA,AZ,73129,36319,36810,39.45,1854
116,23464,VIRGINIA BEACH,VA,72834,34922,37912,16.77,4343
117,92592,TEMECULA,CA,72760,36060,36700,97.23,748
118,60634,CHICAGO,IL,72718,35914,36804,7.11,10223
119,11209,BROOKLYN,NY,72623,33867,38756,2.16,33591
120,77379,SPRING,TX,72579,36468,36111,25.13,2888
121,95630,FOLSOM,CA,72462,39804,32658,27.58,2627
122,94110,SAN FRANCISCO,CA,72128,37502,34626,2.33,31023
123,78577,PHARR,TX,72047,34179,37868,31.75,2269
124,63376,SAINT PETERS,MO,71988,34378,37610,41.54,1733
125,93065,SIMI VALLEY,CA,71899,34457,37442,31.64,2272
126,10469,BRONX,NY,71843,32606,39237,2.48,29004
127,85225,CHANDLER,AZ,71828,35259,36569,12.78,5620
128,10468,BRONX,NY,71822,33969,37853,1.08,66811
129,77083,HOUSTON,TX,71810,33474,38336,10.31,6962
130,60628,CHICAGO,IL,71710,31635,40075,10.92,6567
131,77494,KATY,TX,71613,36238,35375,40.78,1756
132,92805,ANAHEIM,CA,71568,37167,34401,6.3,11353
133,91766,POMONA,CA,71541,34987,36554,10.17,7037
134,91402,PANORAMA CITY,CA,71486,35890,35596,3.73,19181
135,99301,PASCO,WA,71473,36734,34739,464.98,154
136,60505,AURORA,IL,71433,35864,35569,11.17,6398
137,33186,MIAMI,FL,71426,33703,37723,12.64,5652
138,80013,AURORA,CO,71261,35544,35717,13.99,5094
139,89110,LAS VEGAS,NV,71150,36038,35112,11.11,6402
140,60085,WAUKEGAN,IL,70997,35660,35337,14.97,4743
141,93274,TULARE,CA,70820,34793,36027,214.07,331
142,93727,FRESNO,CA,70774,35939,34835,32.51,2177
143,60641,CHICAGO,IL,70730,35618,35112,4.04,17499
144,75228,DALLAS,TX,70699,35309,35390,11.4,6201
145,94587,UNION CITY,CA,70687,34393,36294,19.72,3585
146,10466,BRONX,NY,70609,31429,39180,2.02,34990
147,77450,KATY,TX,70538,33314,37224,20.35,3466
148,10463,BRONX,NY,70420,32184,38236,1.45,48700
149,10457,BRONX,NY,70282,32833,37449,1.06,66241
150,7055,PASSAIC,NJ,70215,35137,35078,3.14,22354
151,90022,LOS ANGELES,CA,70147,34752,35395,4.38,16012
152,90262,LYNWOOD,CA,70137,33545,36592,4.83,14512
153,85032,PHOENIX,AZ,70008,34961,35047,12.42,5636
154,93536,LANCASTER,CA,69988,37475,32513,242.69,288
155,92703,SANTA ANA,CA,69952,36268,33684,4.08,17141
156,94536,FREMONT,CA,69921,35007,34914,14.58,4795
157,21234,PARKVILLE,MD,69893,32308,37585,12.99,5380
158,11375,FOREST HILLS,NY,69757,32444,37313,1.98,35231
159,33024,HOLLYWOOD,FL,69630,34385,35245,10.73,6487
160,97007,BEAVERTON,OR,69469,33788,35681,26.77,2595
161,94533,FAIRFIELD,CA,69067,33189,35878,21.6,3197
162,89108,LAS VEGAS,NV,68972,34864,34108,8.99,7675
163,30349,ATLANTA,GA,68941,31609,37332,45.91,1502
164,10472,BRONX,NY,68898,33278,35620,1.05,65555
165,11215,BROOKLYN,NY,68891,33426,35465,2.18,31630
166,92882,CORONA,CA,68885,34663,34222,25.75,2675
167,27610,RALEIGH,NC,68776,31758,37018,42.72,1610
168,90026,LOS ANGELES,CA,68726,35014,33712,4.23,16267
169,30024,SUWANEE,GA,68650,35336,33314,42.55,1613
170,19111,PHILADELPHIA,PA,68620,33126,35494,4.83,14204
171,11233,BROOKLYN,NY,68599,30379,38220,1.35,50889
172,45011,HAMILTON,OH,68475,33863,34612,60.63,1129
173,92105,SAN DIEGO,CA,68469,33655,34814,5.57,12292
174,77095,HOUSTON,TX,68458,33328,35130,15.39,4449
175,78613,CEDAR PARK,TX,68426,33571,34855,28.09,2436
176,37042,CLARKSVILLE,TN,68419,34041,34378,60.98,1122
177,77036,HOUSTON,TX,68373,36312,32061,7.12,9607
178,60614,CHICAGO,IL,68363,33637,34726,3.17,21593
179,47906,WEST LAFAYETTE,IN,68328,36862,31466,135.68,504
180,95035,MILPITAS,CA,68178,34066,34112,23.24,2933
181,92114,SAN DIEGO,CA,68160,33624,34536,8.24,8274
182,60657,CHICAGO,IL,68088,33716,34372,2.27,29955
183,90631,LA HABRA,CA,68065,33355,34710,13.9,4895
184,7087,UNION CITY,NJ,67566,34292,33274,1.29,52458
185,33157,MIAMI,FL,67553,33051,34502,14.82,4558
186,11746,HUNTINGTON STATION,NY,67412,33548,33864,23.88,2823
187,20906,SILVER SPRING,MD,67387,31664,35723,12.11,5565
188,93306,BAKERSFIELD,CA,67322,32689,34633,88.07,764
189,30096,DULUTH,GA,67110,30734,36376,22.88,2933
190,84118,SALT LAKE CITY,UT,67019,33544,33475,17.13,3913
191,94558,NAPA,CA,66824,33336,33488,355.76,188
192,6902,STAMFORD,CT,66657,34119,32538,10.18,6549
193,19143,PHILADELPHIA,PA,66372,29762,36610,3.19,20819
194,91730,RANCHO CUCAMONGA,CA,66362,32587,33775,14.47,4585
195,92880,CORONA,CA,66353,33485,32868,24.69,2688
196,29483,SUMMERVILLE,SC,66204,31313,34891,135.3,489
197,90003,LOS ANGELES,CA,66200,32356,33844,3.55,18643
198,95687,VACAVILLE,CA,66129,36812,29317,43.52,1519
199,78596,WESLACO,TX,66125,31520,34605,59.36,1114
200,30022,ALPHARETTA,GA,66120,32972,33148,25.44,2599
201,95206,STOCKTON,CA,66092,32967,33125,144.92,456
202,78666,SAN MARCOS,TX,66027,33067,32960,176.55,374
203,30281,STOCKBRIDGE,GA,65931,31394,34537,70.32,938
204,93230,HANFORD,CA,65927,33688,32239,261.81,252
205,75002,ALLEN,TX,65900,30911,34989,37.16,1773
206,11706,BAY SHORE,NY,65821,32721,33100,17.04,3863
207,78542,EDINBURG,TX,65704,33342,32362,169.86,387
208,97006,BEAVERTON,OR,65482,32365,33117,11.75,5573
209,90019,LOS ANGELES,CA,65408,31715,33693,3.89,16823
210,33311,FORT LAUDERDALE,FL,65304,30282,35022,10.35,6311
211,11210,BROOKLYN,NY,65302,30511,34791,1.64,39794
212,96706,EWA BEACH,HI,65260,32982,32278,17.13,3809
213,95127,SAN JOSE,CA,65258,33772,31486,13.01,5015
214,94080,SOUTH SAN FRANCISCO,CA,65200,32499,32701,10.28,6343
215,92021,EL CAJON,CA,65175,32029,33146,29.83,2185
216,33015,HIALEAH,FL,65038,30022,35016,5.83,11165
217,60619,CHICAGO,IL,64922,27990,36932,6.02,10783
218,87114,ALBUQUERQUE,NM,64917,32210,32707,21.3,3048
219,14850,ITHACA,NY,64877,31695,33182,125.96,515
220,33023,HOLLYWOOD,FL,64849,30409,34440,9.64,6729
221,85308,GLENDALE,AZ,64515,31855,32660,17.35,3719
222,80219,DENVER,CO,64506,32825,31681,7.51,8593
223,80015,AURORA,CO,64460,31717,32743,14.3,4508
224,60640,CHICAGO,IL,64365,33857,30508,2.41,26741
225,76244,KELLER,TX,64081,30649,33432,17.18,3729
226,19124,PHILADELPHIA,PA,64044,29974,34070,4.88,13137
227,60402,BERWYN,IL,64039,30772,33267,5.27,12147
228,33411,WEST PALM BEACH,FL,64015,30572,33443,42.65,1501
229,44035,ELYRIA,OH,63911,31074,32837,47.76,1338
230,8753,TOMS RIVER,NJ,63891,31739,32152,23.08,2768
231,7002,BAYONNE,NJ,63819,30961,32858,5.84,10935
232,30062,MARIETTA,GA,63806,31140,32666,25.81,2472
233,92677,LAGUNA NIGUEL,CA,63797,30407,33390,16.7,3821
234,95123,SAN JOSE,CA,63621,31401,32220,8.32,7649
235,20878,GAITHERSBURG,MD,63474,30284,33190,21.83,2907
236,21215,BALTIMORE,MD,63448,29176,34272,6.81,9313
237,11372,JACKSON HEIGHTS,NY,63320,31734,31586,0.74,85916
238,90660,PICO RIVERA,CA,63310,30928,32382,7.75,8169
239,78046,LAREDO,TX,63240,31598,31642,245.94,257
240,7305,JERSEY CITY,NJ,63033,28795,34238,5.81,10858
241,90640,MONTEBELLO,CA,63016,30678,32338,8.49,7422
242,92801,ANAHEIM,CA,62859,31373,31486,6.29,9997
243,10009,NEW YORK,NY,62810,28842,33968,0.62,101799
244,11434,JAMAICA,NY,62809,27959,34850,3.24,19391
245,60609,CHICAGO,IL,62773,31374,31399,7.76,8091
246,90004,LOS ANGELES,CA,62760,31899,30861,3.05,20591
247,23454,VIRGINIA BEACH,VA,62748,30788,31960,30.61,2050
248,48197,YPSILANTI,MI,62684,30797,31887,41.91,1496
249,94509,ANTIOCH,CA,62651,29536,33115,16.43,3813
250,76028,BURLESON,TX,62637,30381,32256,77.14,812
251,10027,NEW YORK,NY,62617,28142,34475,0.87,71891
252,48180,TAYLOR,MI,62592,29757,32835,23.6,2653
253,20011,WASHINGTON,DC,62569,29739,32830,4.88,12829
254,92201,INDIO,CA,62551,30707,31844,22.65,2761
255,91732,EL MONTE,CA,62548,30921,31627,4.62,13553
256,91770,ROSEMEAD,CA,62489,30159,32330,6.42,9729
257,89031,NORTH LAS VEGAS,NV,62455,30551,31904,9.51,6567
258,84015,CLEARFIELD,UT,62387,32043,30344,21.09,2959
259,95624,ELK GROVE,CA,62335,30750,31585,43.98,1417
260,91343,NORTH HILLS,CA,62321,31492,30829,5.91,10543
261,76063,MANSFIELD,TX,62321,31121,31200,51.85,1202
262,44256,MEDINA,OH,62303,30597,31706,133.23,468
263,93906,SALINAS,CA,62073,30474,31599,13.07,4748
264,92562,MURRIETA,CA,62070,30302,31768,109.39,567
265,11213,BROOKLYN,NY,62059,28108,33951,1.09,56883
266,7093,WEST NEW YORK,NJ,61919,30770,31149,1.2,51470
267,92404,SAN BERNARDINO,CA,61918,30180,31738,28.57,2167
268,89121,LAS VEGAS,NV,61911,31451,30460,9.2,6731
269,23322,CHESAPEAKE,VA,61868,33079,28789,150.81,410
270,22191,WOODBRIDGE,VA,61863,30860,31003,15.81,3913
271,90037,LOS ANGELES,CA,61845,30401,31444,2.84,21792
272,78501,MCALLEN,TX,61827,30243,31584,15.34,4030
273,75067,LEWISVILLE,TX,61816,30053,31763,13.29,4651
274,30047,LILBURN,GA,61805,30606,31199,27.71,2230
275,94538,FREMONT,CA,61784,30832,30952,16.46,3753
276,17603,LANCASTER,PA,61719,29745,31974,29.81,2071
277,11432,JAMAICA,NY,61687,29649,32038,2.15,28705
278,94501,ALAMEDA,CA,61639,30085,31554,7.93,7773
279,94015,DALY CITY,CA,61591,29861,31730,5.76,10691
280,95014,CUPERTINO,CA,61521,29769,31752,26.93,2284
281,32244,JACKSONVILLE,FL,61482,29761,31721,23.58,2608
282,34953,PORT SAINT LUCIE,FL,61457,30234,31223,23.8,2582
283,7047,NORTH BERGEN,NJ,61434,29761,31673,5.13,11966
284,90731,SAN PEDRO,CA,61432,30648,30784,9.19,6685
285,85301,GLENDALE,AZ,61387,30901,30486,9.27,6621
286,78520,BROWNSVILLE,TX,61328,29535,31793,36.51,1680
287,10023,NEW YORK,NY,61315,28947,32368,0.49,124878
288,94541,HAYWARD,CA,61311,29268,32043,7.43,8252
289,30135,DOUGLASVILLE,GA,61298,28673,32625,83.76,732
290,78130,NEW BRAUNFELS,TX,61293,29647,31646,92.34,664
291,23462,VIRGINIA BEACH,VA,61287,29585,31702,11.71,5234
292,10701,YONKERS,NY,61167,29147,32020,4.22,14481
293,95758,ELK GROVE,CA,61155,29233,31922,12.83,4768
294,60651,CHICAGO,IL,61150,29466,31684,3.5,17491
295,19134,PHILADELPHIA,PA,61108,30380,30728,3.51,17420
296,11691,FAR ROCKAWAY,NY,61091,28055,33036,2.83,21556
297,92115,SAN DIEGO,CA,61084,30675,30409,6.5,9392
298,95828,SACRAMENTO,CA,60993,30673,30320,12.32,4953
299,21122,PASADENA,MD,60968,30518,30450,31.3,1948
300,93905,SALINAS,CA,60905,32061,28844,9.31,6544
301,85204,MESA,AZ,60819,30199,30620,9.91,6140
302,28277,CHARLOTTE,NC,60794,28372,32422,23.4,2599
303,60016,DES PLAINES,IL,60794,29984,30810,10.63,5722
304,91950,NATIONAL CITY,CA,60784,30927,29857,7.6,7999
305,44060,MENTOR,OH,60780,29182,31598,38.52,1578
306,30906,AUGUSTA,GA,60634,28681,31953,84.45,718
307,90042,LOS ANGELES,CA,60623,29653,30970,4.64,13054
308,21740,HAGERSTOWN,MD,60616,31010,29606,69.85,868
309,78574,MISSION,TX,60589,29426,31163,58.82,1030
310,91977,SPRING VALLEY,CA,60542,30335,30207,9.67,6264
311,6010,BRISTOL,CT,60525,29846,30679,26.4,2292
312,53215,MILWAUKEE,WI,60508,30262,30246,5.66,10690
313,87120,ALBUQUERQUE,NM,60487,29694,30793,38.42,1574
314,23452,VIRGINIA BEACH,VA,60422,29294,31128,14.64,4127
315,43055,NEWARK,OH,60396,29099,31297,112.81,535
316,78245,SAN ANTONIO,TX,60333,30054,30279,33.22,1816
317,10977,SPRING VALLEY,NY,60293,29998,30295,11.1,5431
318,92707,SANTA ANA,CA,60288,30173,30115,5.03,11990
319,37075,HENDERSONVILLE,TN,60280,29209,31071,59.37,1015
320,95608,CARMICHAEL,CA,60255,29122,31133,13.04,4620
321,60073,ROUND LAKE,IL,60237,30478,29759,20.5,2938
322,46307,CROWN POINT,IN,60191,29965,30226,87.66,687
323,10128,NEW YORK,NY,60121,25724,34397,0.47,127645
324,10312,STATEN ISLAND,NY,60081,30010,30071,7.68,7824
325,91702,AZUSA,CA,60036,29482,30554,169.36,354
326,30127,POWDER SPRINGS,GA,60016,28520,31496,50.77,1182
327,97229,PORTLAND,OR,59983,29838,30145,20.56,2917
328,98052,REDMOND,WA,59822,31150,28672,20.1,2977
329,2148,MALDEN,MA,59819,28701,31118,5.04,11859
330,19720,NEW CASTLE,DE,59808,28688,31120,37.1,1612
331,75040,GARLAND,TX,59792,29605,30187,15.65,3820
332,94806,SAN PABLO,CA,59720,29373,30347,8.33,7167
333,73099,YUKON,OK,59634,28659,30975,121.29,492
334,95111,SAN JOSE,CA,59521,29948,29573,5.39,11035
335,90006,LOS ANGELES,CA,59498,30859,28639,1.92,30989
336,93309,BAKERSFIELD,CA,59489,29171,30318,10.65,5588
337,92627,COSTA MESA,CA,59488,30524,28964,6.35,9370
338,43130,LANCASTER,OH,59486,29852,29634,161.89,367
339,93030,OXNARD,CA,59435,30367,29068,13.87,4286
340,92630,LAKE FOREST,CA,59401,29018,30383,9.52,6237
341,33647,TAMPA,FL,59375,28354,31021,33.89,1752
342,10032,NEW YORK,NY,59374,29080,30294,0.66,90371
343,15601,GREENSBURG,PA,59313,28581,30732,86.2,688
344,79938,EL PASO,TX,59252,30546,28706,364.35,163
345,30052,LOGANVILLE,GA,59226,28994,30232,87.46,677
346,11225,BROOKLYN,NY,59182,26387,32795,0.88,66948
347,90813,LONG BEACH,CA,59178,30019,29159,3.21,18441
348,10024,NEW YORK,NY,59164,27166,31998,0.86,68956
349,79924,EL PASO,TX,59115,27825,31290,12.24,4829
350,95355,MODESTO,CA,59111,27686,31425,9.49,6229
351,30331,ATLANTA,GA,59107,26812,32295,37.02,1597
352,32825,ORLANDO,FL,59099,27671,31428,28.81,2052
353,10031,NEW YORK,NY,59092,28360,30732,0.65,90771
354,90066,LOS ANGELES,CA,59031,29446,29585,4.92,11993
355,89123,LAS VEGAS,NV,58991,28974,30017,10.66,5535
356,2301,BROCKTON,MA,58982,28086,30896,12.43,4744
357,43123,GROVE CITY,OH,58964,28761,30203,59.52,991
358,91761,ONTARIO,CA,58919,28636,30283,29.17,2020
359,89115,LAS VEGAS,NV,58870,30214,28656,25.01,2354
360,2155,MEDFORD,MA,58832,28054,30778,8.2,7177
361,60411,CHICAGO HEIGHTS,IL,58818,28155,30663,31.73,1853
362,78228,SAN ANTONIO,TX,58783,28874,29909,10.93,5377
363,92780,TUSTIN,CA,58755,28947,29808,6.99,8403
364,10033,NEW YORK,NY,58710,29934,28776,0.61,97041
365,90034,LOS ANGELES,CA,58703,29229,29474,3.11,18857
366,10473,BRONX,NY,58660,25617,33043,2.18,26908
367,74012,BROKEN ARROW,OK,58607,29144,29463,24.76,2367
368,97701,BEND,OR,58602,28483,30119,678.9,86
369,20874,GERMANTOWN,MD,58537,28403,30134,21.22,2759
370,32828,ORLANDO,FL,58491,28636,29855,21.37,2737
371,32210,JACKSONVILLE,FL,58455,26986,31469,20.15,2901
372,75149,MESQUITE,TX,58427,28031,30396,15.88,3679
373,22003,ANNANDALE,VA,58390,27953,30437,12.44,4694
374,46227,INDIANAPOLIS,IN,58348,27760,30588,16.75,3483
375,92407,SAN BERNARDINO,CA,58275,28603,29672,62.89,927
376,95020,GILROY,CA,58246,29280,28966,155.94,374
377,30040,CUMMING,GA,58225,28883,29342,58.68,992
378,77459,MISSOURI CITY,TX,58197,28272,29925,32.78,1775
379,85345,PEORIA,AZ,58170,28638,29532,13.05,4457
380,90745,CARSON,CA,58162,28626,29536,8.3,7007
381,92113,SAN DIEGO,CA,58158,31759,26399,5.27,11038
382,32765,OVIEDO,FL,58153,28064,30089,39.11,1487
383,78586,SAN BENITO,TX,58144,28269,29875,176.31,330
384,75150,MESQUITE,TX,58143,27282,30861,12.74,4562
385,75043,GARLAND,TX,58120,28049,30071,14.53,4001
386,43026,HILLIARD,OH,58097,28221,29876,35.08,1656
387,92647,HUNTINGTON BEACH,CA,58081,28865,29216,7.75,7495
388,87105,ALBUQUERQUE,NM,57937,28874,29063,93.92,617
389,60630,CHICAGO,IL,57886,28517,29369,4.77,12125
390,78664,ROUND ROCK,TX,57806,28323,29483,16.56,3490
391,78045,LAREDO,TX,57801,27903,29898,723.53,80
392,33025,HOLLYWOOD,FL,57766,27852,29914,10.82,5340
393,20147,ASHBURN,VA,57758,27767,29991,19.87,2906
394,92020,EL CAJON,CA,57747,28474,29273,11.14,5186
395,78745,AUSTIN,TX,57559,28404,29155,13.35,4311
396,87111,ALBUQUERQUE,NM,57554,27224,30330,21.68,2655
397,92346,HIGHLAND,CA,57499,29349,28150,25.41,2263
398,33027,HOLLYWOOD,FL,57479,25614,31865,13.42,4282
399,45601,CHILLICOTHE,OH,57449,30828,26621,341.98,168
400,11717,BRENTWOOD,NY,57375,29190,28185,10.93,5252
401,94122,SAN FRANCISCO,CA,57369,28174,29195,2.36,24268
402,90744,WILMINGTON,CA,57358,28834,28524,8.34,6880
403,85041,PHOENIX,AZ,57329,27582,29747,15.87,3612
404,92324,COLTON,CA,57326,28894,28432,29.51,1943
405,10003,NEW YORK,NY,57310,27442,29868,0.58,99497
406,66061,OLATHE,KS,57167,29119,28048,64.15,891
407,80134,PARKER,CO,57110,28243,28867,56.35,1013
408,77015,HOUSTON,TX,57096,29051,28045,21.12,2704
409,85706,TUCSON,AZ,56989,27885,29104,12.53,4549
410,60506,AURORA,IL,56982,28190,28792,18.72,3044
411,33313,FORT LAUDERDALE,FL,56934,26420,30514,6.51,8752
412,27858,GREENVILLE,NC,56930,27469,29461,60.24,945
413,75243,DALLAS,TX,56910,27380,29530,8.7,6539
414,21117,OWINGS MILLS,MD,56894,26333,30561,32.52,1750
415,8854,PISCATAWAY,NJ,56874,28039,28835,18.83,3021
416,33463,LAKE WORTH,FL,56864,27832,29032,10.74,5293
417,31907,COLUMBUS,GA,56859,26846,30013,22.98,2475
418,60453,OAK LAWN,IL,56820,26955,29865,8.46,6719
419,2360,PLYMOUTH,MA,56816,28203,28613,95.51,595
420,11550,HEMPSTEAD,NY,56773,27432,29341,4.26,13327
421,84404,OGDEN,UT,56743,28417,28326,93.15,609
422,29445,GOOSE CREEK,SC,56629,29742,26887,58.52,968
423,75227,DALLAS,TX,56594,27985,28609,11.4,4966
424,28027,CONCORD,NC,56586,27824,28762,68.6,825
425,76010,ARLINGTON,TX,56512,29249,27263,8.94,6323
426,92708,FOUNTAIN VALLEY,CA,56510,28245,28265,9.06,6237
427,22407,FREDERICKSBURG,VA,56381,27698,28683,56.7,994
428,33177,MIAMI,FL,56355,28860,27495,12.52,4500
429,40475,RICHMOND,KY,56351,27113,29238,273,206
430,44077,PAINESVILLE,OH,56334,27760,28574,60.19,936
431,20002,WASHINGTON,DC,56331,27655,28676,5.26,10715
432,43081,WESTERVILLE,OH,56325,27051,29274,24.62,2287
433,33165,MIAMI,FL,56275,26622,29653,7.62,7387
434,7728,FREEHOLD,NJ,56270,28467,27803,48.56,1159
435,11354,FLUSHING,NY,56258,27046,29212,2.17,25961
436,92563,MURRIETA,CA,56252,27953,28299,20.34,2766
437,63021,BALLWIN,MO,56217,26771,29446,21.8,2578
438,30093,NORCROSS,GA,56213,29135,27078,11.93,4713
439,77072,HOUSTON,TX,56199,28798,27401,7.32,7680
440,30041,CUMMING,GA,56176,27587,28589,58.83,955
441,42101,BOWLING GREEN,KY,56169,27401,28768,283.11,198
442,77840,COLLEGE STATION,TX,56154,29383,26771,11.2,5013
443,93215,DELANO,CA,56141,32500,23641,141.89,396
444,32822,ORLANDO,FL,56111,27739,28372,13.29,4221
445,70072,MARRERO,LA,56088,26570,29518,20.75,2703
446,10460,BRONX,NY,56084,26378,29706,1.32,42649
447,60638,CHICAGO,IL,56033,27208,28825,11.1,5048
448,32218,JACKSONVILLE,FL,56025,27334,28691,96.67,580
449,85033,PHOENIX,AZ,56009,28289,27720,6.1,9188
450,91762,ONTARIO,CA,55982,26969,29013,13.62,4109
451,77373,SPRING,TX,55927,28024,27903,23.72,2358
452,10306,STATEN ISLAND,NY,55902,26875,29027,7.47,7481
453,93063,SIMI VALLEY,CA,55846,28124,27722,32.95,1695
454,96817,HONOLULU,HI,55812,27254,28558,9.29,6011
455,91605,NORTH HOLLYWOOD,CA,55793,27707,28086,5.46,10211
456,91745,HACIENDA HEIGHTS,CA,55776,26438,29338,12.81,4355
457,98682,VANCOUVER,WA,55759,27563,28196,30.16,1849
458,78250,SAN ANTONIO,TX,55723,27009,28714,9.61,5797
459,20904,SILVER SPRING,MD,55688,25922,29766,13.67,4074
460,65807,SPRINGFIELD,MO,55658,26217,29441,21.7,2564
461,93458,SANTA MARIA,CA,55651,28978,26673,27.37,2033
462,19020,BENSALEM,PA,55650,27883,27767,17.24,3229
463,27406,GREENSBORO,NC,55645,26251,29394,69.41,802
464,60056,MOUNT PROSPECT,IL,55611,27664,27947,10.75,5172
465,43701,ZANESVILLE,OH,55568,26897,28671,180.33,308
466,77433,CYPRESS,TX,55563,27389,28174,58.33,953
467,85281,TEMPE,AZ,55548,30006,25542,13.35,4161
468,93312,BAKERSFIELD,CA,55539,27887,27652,15.22,3650
469,94109,SAN FRANCISCO,CA,55519,27853,27666,1.19,46733
470,92840,GARDEN GROVE,CA,55513,28364,27149,5.2,10671
471,22030,FAIRFAX,VA,55490,27517,27973,18.87,2941
472,94513,BRENTWOOD,CA,55488,27810,27678,75.66,733
473,95112,SAN JOSE,CA,55481,29280,26201,7.09,7822
474,11237,BROOKLYN,NY,55478,28461,27017,0.98,56610
475,8901,NEW BRUNSWICK,NJ,55476,27882,27594,6.33,8765
476,92027,ESCONDIDO,CA,55461,27022,28439,63.06,879
477,95122,SAN JOSE,CA,55438,27766,27672,4.77,11625
478,97301,SALEM,OR,55437,28807,26630,11.58,4787
479,6516,WEST HAVEN,CT,55349,26655,28694,10.75,5150
480,28655,MORGANTON,NC,55330,27993,27337,318.05,174
481,85710,TUCSON,AZ,55323,26263,29060,12.08,4581
482,65203,COLUMBIA,MO,55284,26428,28856,77.25,716
483,30075,ROSWELL,GA,55253,26872,28381,29.82,1853
484,72401,JONESBORO,AR,55197,26610,28587,117.22,471
485,92646,HUNTINGTON BEACH,CA,55184,26270,28914,8.05,6859
486,30101,ACWORTH,GA,55141,27092,28049,40.35,1367
487,19446,LANSDALE,PA,55090,27110,27980,22.55,2443
488,2169,QUINCY,MA,55064,26583,28481,8.97,6138
489,11758,MASSAPEQUA,NY,55009,26837,28172,11,5001
490,45840,FINDLAY,OH,54941,26609,28332,167.69,328
491,92057,OCEANSIDE,CA,54901,27663,27238,15.09,3639
492,28215,CHARLOTTE,NC,54896,25804,29092,30.53,1798
493,84119,WEST VALLEY CITY,UT,54882,28167,26715,12.06,4551
494,33064,POMPANO BEACH,FL,54879,27132,27747,10.46,5245
495,8527,JACKSON,NJ,54867,26774,28093,85.26,644
496,7470,WAYNE,NJ,54849,26138,28711,23.78,2307
497,43302,MARION,OH,54800,29571,25229,195.09,281
498,90001,LOS ANGELES,CA,54760,26926,27834,3.5,15637
499,96789,MILILANI,HI,54731,28056,26675,27.28,2006
500,31419,SAVANNAH,GA,54730,25760,28970,63.55,861
501,30004,ALPHARETTA,GA,54714,27553,27161,57.39,953
502,27834,GREENVILLE,NC,54699,24828,29871,176.91,309
503,11201,BROOKLYN,NY,54668,26994,27674,1.42,38471
504,80634,GREELEY,CO,54656,26621,28035,37.28,1466
505,55106,SAINT PAUL,MN,54648,27022,27626,8.67,6306
506,89117,LAS VEGAS,NV,54646,26259,28387,9.12,5991
507,77346,HUMBLE,TX,54627,27006,27621,17.36,3147
508,34711,CLERMONT,FL,54609,26850,27759,41.84,1305
509,48103,ANN ARBOR,MI,54593,26703,27890,65.08,839
510,12550,NEWBURGH,NY,54565,26214,28351,34.72,1572
511,79907,EL PASO,TX,54563,25561,29002,13.61,4010
512,92392,VICTORVILLE,CA,54557,26074,28483,37.33,1462
513,29732,ROCK HILL,SC,54548,26488,28060,53.33,1023
514,21222,DUNDALK,MD,54523,26166,28357,10.96,4974
515,33414,WELLINGTON,FL,54474,26177,28297,28.07,1941
516,92071,SANTEE,CA,54469,25768,28701,17.43,3125
517,90723,PARAMOUNT,CA,54468,27289,27179,4.69,11626
518,91405,VAN NUYS,CA,54435,27254,27181,3.31,16451
519,85705,TUCSON,AZ,54433,27795,26638,13.59,4004
520,93436,LOMPOC,CA,54433,28007,26426,218.92,249
521,73160,OKLAHOMA CITY,OK,54420,25969,28451,22.45,2424
522,94087,SUNNYVALE,CA,54362,27319,27043,6.58,8258
523,38401,COLUMBIA,TN,54353,26180,28173,300.73,181
524,76137,FORT WORTH,TX,54345,26907,27438,13.54,4015
525,60622,CHICAGO,IL,54272,26902,27370,2.45,22125
526,93117,GOLETA,CA,54251,27160,27091,170.08,319
527,92504,RIVERSIDE,CA,54221,27000,27221,23.41,2317
528,22192,WOODBRIDGE,VA,54216,25723,28493,18.55,2923
529,95125,SAN JOSE,CA,54200,25773,28427,8.01,6771
530,33142,MIAMI,FL,54178,27104,27074,7.08,7658
531,30188,WOODSTOCK,GA,54177,26115,28062,43.97,1232
532,91801,ALHAMBRA,CA,54176,26178,27998,4.36,12431
533,90063,LOS ANGELES,CA,54160,27229,26931,3.27,16548
534,92507,RIVERSIDE,CA,54152,26291,27861,20.21,2680
535,7111,IRVINGTON,NJ,54144,25494,28650,2.93,18492
536,78681,ROUND ROCK,TX,54141,27243,26898,21.73,2492
537,92701,SANTA ANA,CA,54117,27797,26320,3.27,16550
538,92570,PERRIS,CA,54115,27363,26752,97.31,556
539,30058,LITHONIA,GA,54053,24339,29714,30.78,1756
540,33161,MIAMI,FL,54036,25423,28613,5.47,9882
541,84095,SOUTH JORDAN,UT,53995,27366,26629,22.65,2384
542,78207,SAN ANTONIO,TX,53946,28500,25446,7.26,7428
543,61761,NORMAL,IL,53926,25700,28226,42.57,1267
544,27587,WAKE FOREST,NC,53860,26918,26942,104.79,514
545,60440,BOLINGBROOK,IL,53836,26640,27196,16.08,3349
546,92571,PERRIS,CA,53820,26119,27701,22.56,2386
547,96744,KANEOHE,HI,53818,26212,27606,34.48,1561
548,12180,TROY,NY,53812,27085,26727,54.89,980
549,11216,BROOKLYN,NY,53783,25270,28513,0.94,57522
550,19140,PHILADELPHIA,PA,53778,24925,28853,3.05,17621
551,7306,JERSEY CITY,NJ,53767,27675,26092,2.72,19753
552,17602,LANCASTER,PA,53743,26697,27046,25.63,2097
553,93291,VISALIA,CA,53742,27203,26539,84.64,635
554,19149,PHILADELPHIA,PA,53731,25536,28195,2.43,22121
555,45013,HAMILTON,OH,53697,25747,27950,115.44,465
556,91764,ONTARIO,CA,53688,26389,27299,8.01,6706
557,93308,BAKERSFIELD,CA,53639,26840,26799,316.01,170
558,30318,ATLANTA,GA,53622,27943,25679,20.36,2633
559,33065,POMPANO BEACH,FL,53614,26056,27558,8.33,6439
560,78852,EAGLE PASS,TX,53600,26208,27392,572.47,94
561,94591,VALLEJO,CA,53548,26048,27500,21.58,2482
562,11435,JAMAICA,NY,53542,26654,26888,1.52,35341
563,24060,BLACKSBURG,VA,53541,29164,24377,132.62,404
564,7083,UNION,NJ,53503,25284,28219,8.65,6186
565,21061,GLEN BURNIE,MD,53491,25776,27715,12.14,4407
566,14221,BUFFALO,NY,53475,24867,28608,22.99,2326
567,99654,WASILLA,AK,53456,27784,25672,497.87,107
568,95747,ROSEVILLE,CA,53452,25175,28277,46.62,1147
569,33125,MIAMI,FL,53435,25806,27629,3.86,13836
570,8861,PERTH AMBOY,NJ,53415,26124,27291,5.19,10288
571,19382,WEST CHESTER,PA,53404,26116,27288,46.28,1154
572,92129,SAN DIEGO,CA,53387,26449,26938,14.07,3794
573,92399,YUCAIPA,CA,53370,26942,26428,53.03,1006
574,23320,CHESAPEAKE,VA,53339,24969,28370,32.61,1636
575,30080,SMYRNA,GA,53298,25399,27899,13.62,3913
576,95670,RANCHO CORDOVA,CA,53259,26152,27107,12.55,4242
577,75061,IRVING,TX,53233,26875,26358,11.56,4604
578,91304,CANOGA PARK,CA,53194,25553,27641,9.41,5655
579,32837,ORLANDO,FL,53184,26254,26930,22.44,2370
580,77077,HOUSTON,TX,53158,25837,27321,8.72,6100
581,95051,SANTA CLARA,CA,53152,26443,26709,6.66,7983
582,78240,SAN ANTONIO,TX,53145,25977,27168,11.32,4696
583,32225,JACKSONVILLE,FL,53130,26002,27128,26.42,2011
584,96734,KAILUA,HI,53068,27118,25950,21.73,2442
585,6511,NEW HAVEN,CT,53062,24596,28466,5.93,8950
586,85008,PHOENIX,AZ,52966,27589,25377,10.47,5060
587,70726,DENHAM SPRINGS,LA,52962,26123,26839,92.8,571
588,48044,MACOMB,MI,52927,25600,27327,13.5,3920
589,77088,HOUSTON,TX,52924,25931,26993,11.18,4732
590,28314,FAYETTEVILLE,NC,52916,26028,26888,23.04,2297
591,33312,FORT LAUDERDALE,FL,52915,27121,25794,11.43,4632
592,91344,GRANADA HILLS,CA,52892,25996,26896,16.41,3222
593,19702,NEWARK,DE,52830,25751,27079,28.31,1866
594,43230,COLUMBUS,OH,52819,25333,27486,20.93,2524
595,27410,GREENSBORO,NC,52812,25184,27628,32.69,1615
596,19104,PHILADELPHIA,PA,52800,26439,26361,3.01,17559
597,19320,COATESVILLE,PA,52798,26016,26782,84.51,625
598,55901,ROCHESTER,MN,52796,25424,27372,29.87,1767
599,92870,PLACENTIA,CA,52794,26128,26666,6.79,7773
600,28078,HUNTERSVILLE,NC,52776,26680,26096,63.8,827
601,63129,SAINT LOUIS,MO,52733,25599,27134,20.9,2523
602,98208,EVERETT,WA,52683,26208,26475,16.19,3255
603,91406,VAN NUYS,CA,52682,26282,26400,8.13,6478
604,78753,AUSTIN,TX,52674,27637,25037,10.97,4803
605,92117,SAN DIEGO,CA,52648,27024,25624,8.79,5992
606,43068,REYNOLDSBURG,OH,52605,24786,27819,19.36,2718
607,30263,NEWNAN,GA,52604,25991,26613,199.74,263
608,20019,WASHINGTON,DC,52572,22244,30328,6.17,8521
609,33063,POMPANO BEACH,FL,52564,24775,27789,8.89,5910
610,22554,STAFFORD,VA,52564,26983,25581,66.36,792
611,77498,SUGAR LAND,TX,52545,26285,26260,15.48,3394
612,2151,REVERE,MA,52534,26653,25881,5.87,8957
613,43228,COLUMBUS,OH,52522,25043,27479,20.24,2595
614,29730,ROCK HILL,SC,52496,25174,27322,120.04,437
615,90221,COMPTON,CA,52446,25617,26829,5.33,9836
616,93304,BAKERSFIELD,CA,52421,26402,26019,7.6,6902
617,45140,LOVELAND,OH,52417,25937,26480,46.32,1132
618,96819,HONOLULU,HI,52416,26490,25926,21.89,2395
619,83301,TWIN FALLS,ID,52396,25885,26511,281.69,186
620,60148,LOMBARD,IL,52390,25429,26961,13.55,3866
621,98012,BOTHELL,WA,52351,25517,26834,15.32,3417
622,33175,MIAMI,FL,52348,25389,26959,7.7,6799
623,30253,MCDONOUGH,GA,52256,24914,27342,48.52,1077
624,78550,HARLINGEN,TX,52238,25536,26702,95.61,546
625,92833,FULLERTON,CA,52232,25355,26877,7.31,7150
626,48228,DETROIT,MI,52191,24501,27690,8.61,6062
627,92056,OCEANSIDE,CA,52182,25932,26250,12.41,4204
628,10011,NEW YORK,NY,52167,26039,26128,0.66,79281
629,89129,LAS VEGAS,NV,52145,25285,26860,10.01,5211
630,85122,CASA GRANDE,AZ,52136,25241,26895,50.02,1042
631,83709,BOISE,ID,52110,26539,25571,34.77,1499
632,85326,BUCKEYE,AZ,52101,27815,24286,368.68,141
633,72764,SPRINGDALE,AR,52101,26338,25763,62.27,837
634,45044,MIDDLETOWN,OH,52064,25615,26449,38.13,1366
635,30066,MARIETTA,GA,52060,26009,26051,27.24,1911
636,30083,STONE MOUNTAIN,GA,52056,23999,28057,16.97,3068
637,87124,RIO RANCHO,NM,52049,24877,27172,70.41,739
638,37167,SMYRNA,TN,51973,24808,27165,57.54,903
639,92234,CATHEDRAL CITY,CA,51927,26500,25427,15.73,3301
640,75025,PLANO,TX,51924,25321,26603,9.33,5568
641,92626,COSTA MESA,CA,51904,26312,25592,9.62,5394
642,44107,LAKEWOOD,OH,51899,25192,26707,5.52,9409
643,11238,BROOKLYN,NY,51895,24285,27610,1.11,46921
644,30144,KENNESAW,GA,51872,25407,26465,22.57,2298
645,28227,CHARLOTTE,NC,51870,25977,25893,38.7,1340
646,27284,KERNERSVILLE,NC,51849,24544,27305,79.91,649
647,60643,CHICAGO,IL,51836,23621,28215,7.35,7056
648,33511,BRANDON,FL,51807,25016,26791,15.89,3261
649,78251,SAN ANTONIO,TX,51767,25782,25985,15.18,3410
650,30721,DALTON,GA,51763,26106,25657,124.24,417
651,28110,MONROE,NC,51733,25710,26023,128.64,402
652,10461,BRONX,NY,51730,25227,26503,2.4,21554
653,33467,LAKE WORTH,FL,51606,24668,26938,18.41,2803
654,93277,VISALIA,CA,51604,24943,26661,39.98,1291
655,96818,HONOLULU,HI,51522,25339,26183,11.51,4475
656,84043,LEHI,UT,51511,26206,25305,31.12,1655
657,94539,FREMONT,CA,51494,25695,25799,25.42,2026
658,45040,MASON,OH,51469,24848,26621,28.09,1832
659,85234,GILBERT,AZ,51459,24890,26569,11.91,4322
660,19148,PHILADELPHIA,PA,51455,25389,26066,4.22,12184
661,75035,FRISCO,TX,51444,25736,25708,23.64,2176
662,89147,LAS VEGAS,NV,51419,25036,26383,7.42,6926
663,75007,CARROLLTON,TX,51405,25722,25683,11.65,4414
664,37064,FRANKLIN,TN,51393,25164,26229,178.55,288
665,2124,DORCHESTER CENTER,MA,51382,24217,27165,3,17110
666,91786,UPLAND,CA,51381,24413,26968,8.95,5739
667,85035,PHOENIX,AZ,51329,24453,26876,5.71,8985
668,1960,PEABODY,MA,51319,24352,26967,16,3208
669,23456,VIRGINIA BEACH,VA,51261,25905,25356,50.6,1013
670,79928,EL PASO,TX,51248,25739,25509,104.1,492
671,36117,MONTGOMERY,AL,51223,24904,26319,54.29,944
672,60120,ELGIN,IL,51216,25513,25703,16.59,3088
673,96816,HONOLULU,HI,51209,25191,26018,9.9,5175
674,33176,MIAMI,FL,51207,24746,26461,12.27,4175
675,10016,NEW YORK,NY,51196,23097,28099,0.53,96233
676,67401,SALINA,KS,51196,25217,25979,240.01,213
677,92557,MORENO VALLEY,CA,51196,24726,26470,18.8,2723
678,85142,QUEEN CREEK,AZ,51190,25293,25897,70.98,721
679,77089,HOUSTON,TX,51184,25535,25649,12.72,4025
680,20020,WASHINGTON,DC,51176,22983,28193,4.61,11094
681,33033,HOMESTEAD,FL,51131,25803,25328,16.78,3047
682,80229,DENVER,CO,51123,25417,25706,13.16,3884
683,85282,TEMPE,AZ,51080,26186,24894,11.18,4571
684,60626,CHICAGO,IL,51061,25579,25482,1.71,29948
685,29072,LEXINGTON,SC,51055,25216,25839,68.47,746
686,8873,SOMERSET,NJ,51048,24428,26620,32.28,1581
687,97045,OREGON CITY,OR,51040,26164,24876,86.35,591
688,37027,BRENTWOOD,TN,51034,25121,25913,55.07,927
689,97402,EUGENE,OR,51025,25389,25636,69.08,739
690,95116,SAN JOSE,CA,51010,26096,24914,3.58,14249
691,70065,KENNER,LA,50989,24588,26401,8.03,6349
692,90024,LOS ANGELES,CA,50964,23875,27089,2.94,17346
693,7030,HOBOKEN,NJ,50929,25120,25809,1.26,40292
694,30016,COVINGTON,GA,50852,24061,26791,91.57,555
695,19711,NEWARK,DE,50844,24679,26165,27.38,1857
696,92656,ALISO VIEJO,CA,50820,24249,26571,8.23,6176
697,7104,NEWARK,NJ,50813,24867,25946,2.53,20052
698,14094,LOCKPORT,NY,50807,24685,26122,121.93,417
699,77845,COLLEGE STATION,TX,50799,24935,25864,147.54,344
700,19067,MORRISVILLE,PA,50790,24866,25924,28.5,1782
701,8081,SICKLERVILLE,NJ,50784,24210,26574,26.72,1900
702,28540,JACKSONVILLE,NC,50745,25948,24797,103.2,492
703,73505,LAWTON,OK,50737,24448,26289,55.26,918
704,29223,COLUMBIA,SC,50639,24249,26390,25.51,1985
705,20744,FORT WASHINGTON,MD,50632,23916,26716,26.34,1922
706,23112,MIDLOTHIAN,VA,50595,25159,25436,32.4,1561
707,33458,JUPITER,FL,50580,24686,25894,21.65,2337
708,14580,WEBSTER,NY,50559,24235,26324,42.6,1187
709,76133,FORT WORTH,TX,50558,23810,26748,9.24,5473
710,37130,MURFREESBORO,TN,50538,25569,24969,52.32,966
711,78223,SAN ANTONIO,TX,50536,25180,25356,41.41,1220
712,46143,GREENWOOD,IN,50521,25219,25302,48.81,1035
713,90046,LOS ANGELES,CA,50499,26451,24048,5.78,8737
714,78249,SAN ANTONIO,TX,50491,24349,26142,14.86,3399
715,7105,NEWARK,NJ,50466,29050,21416,4.64,10879
716,93003,VENTURA,CA,50446,24711,25735,20.58,2451
717,44130,CLEVELAND,OH,50416,24251,26165,17.12,2944
718,75287,DALLAS,TX,50416,24462,25954,5.6,9006
719,77521,BAYTOWN,TX,50406,24450,25956,41.47,1215
720,99208,SPOKANE,WA,50372,23643,26729,49.16,1025
721,45424,DAYTON,OH,50366,24567,25799,31.54,1597
722,83646,MERIDIAN,ID,50342,24424,25918,27.56,1827
723,17331,HANOVER,PA,50336,24618,25718,75.8,664
724,38305,JACKSON,TN,50335,23720,26615,129.37,389
725,93551,PALMDALE,CA,50306,24595,25711,73.14,688
726,95350,MODESTO,CA,50260,24173,26087,8.88,5661
727,89052,HENDERSON,NV,50246,24056,26190,51.92,968
728,33068,POMPANO BEACH,FL,50207,24041,26166,5.96,8425
729,21206,BALTIMORE,MD,50182,22690,27492,7.21,6963
730,32808,ORLANDO,FL,50146,24193,25953,11.98,4187
731,92530,LAKE ELSINORE,CA,50141,25705,24436,53.88,931
732,28025,CONCORD,NC,50140,24058,26082,108.9,460
733,30114,CANTON,GA,50138,24632,25506,107.89,465
734,21207,GWYNN OAK,MD,50107,22089,28018,10.31,4859
735,19380,WEST CHESTER,PA,50098,24462,25636,31.55,1588
736,37129,MURFREESBORO,TN,50076,24865,25211,81.64,613
737,95023,HOLLISTER,CA,50067,24882,25185,412.35,121
738,35242,BIRMINGHAM,AL,50052,24329,25723,52.96,945
739,40601,FRANKFORT,KY,49984,24135,25849,220.48,227
740,20009,WASHINGTON,DC,49979,25744,24235,1.32,38007
741,59901,KALISPELL,MT,49962,24124,25838,452.11,111
742,30907,AUGUSTA,GA,49959,24342,25617,24,2082
743,60004,ARLINGTON HEIGHTS,IL,49957,24307,25650,11.08,4508
744,78504,MCALLEN,TX,49936,24909,25027,17.68,2824
745,77082,HOUSTON,TX,49920,24142,25778,12.55,3976
746,31088,WARNER ROBINS,GA,49883,24588,25295,31.43,1587
747,75115,DESOTO,TX,49839,22952,26887,21.94,2272
748,48823,EAST LANSING,MI,49813,24721,25092,22.43,2221
749,32162,THE VILLAGES,FL,49812,23308,26504,23.13,2154
750,90220,COMPTON,CA,49810,23622,26188,6.91,7208
751,6810,DANBURY,CT,49777,24055,25722,20.69,2406
752,20854,POTOMAC,MD,49759,24151,25608,33.75,1474
753,32246,JACKSONVILLE,FL,49747,24169,25578,18.95,2625
754,41042,FLORENCE,KY,49747,24349,25398,28.65,1736
755,54601,LA CROSSE,WI,49744,23500,26244,73.55,676
756,85713,TUCSON,AZ,49712,25238,24474,23.69,2098
757,85009,PHOENIX,AZ,49710,27424,22286,15.58,3190
758,29681,SIMPSONVILLE,SC,49692,24661,25031,41.35,1202
759,63031,FLORISSANT,MO,49650,23482,26168,14.68,3383
760,55124,SAINT PAUL,MN,49632,24534,25098,16.81,2952
761,76179,FORT WORTH,TX,49578,24426,25152,54.02,918
762,45069,WEST CHESTER,OH,49559,24327,25232,28.44,1743
763,21218,BALTIMORE,MD,49552,23077,26475,4.18,11843
764,21224,BALTIMORE,MD,49552,24837,24715,9.48,5230
765,63301,SAINT CHARLES,MO,49549,25315,24234,88.38,561
766,89103,LAS VEGAS,NV,49537,25906,23631,6.7,7399
767,92026,ESCONDIDO,CA,49537,24404,25133,37.21,1331
768,60613,CHICAGO,IL,49536,24808,24728,2.18,22765
769,90703,CERRITOS,CA,49526,23648,25878,8.78,5641
770,22204,ARLINGTON,VA,49521,24804,24717,4.11,12046
771,75056,THE COLONY,TX,49514,24765,24749,25.25,1961
772,78247,SAN ANTONIO,TX,49514,24127,25387,16.41,3017
773,48858,MOUNT PLEASANT,MI,49502,23898,25604,172.88,286
774,80631,GREELEY,CO,49501,24516,24985,102.85,481
775,60616,CHICAGO,IL,49491,24006,25485,4.05,12229
776,43015,DELAWARE,OH,49491,24232,25259,124.97,396
777,90002,LOS ANGELES,CA,49475,23989,25486,3.06,16158
778,95376,TRACY,CA,49442,25659,23783,7.64,6476
779,92505,RIVERSIDE,CA,49435,24838,24597,12.22,4044
780,23666,HAMPTON,VA,49434,24459,24975,19.79,2498
781,63123,SAINT LOUIS,MO,49390,24049,25341,12.56,3933
782,75216,DALLAS,TX,49342,23692,25650,14.62,3374
783,92128,SAN DIEGO,CA,49332,22829,26503,11.17,4418
784,32792,WINTER PARK,FL,49308,24685,24623,12.29,4012
785,94601,OAKLAND,CA,49279,25806,23473,3.25,15177
786,15301,WASHINGTON,PA,49266,24017,25249,121.91,404
787,77546,FRIENDSWOOD,TX,49255,24858,24397,26.37,1868
788,90638,LA MIRADA,CA,49222,24113,25109,7.88,6244
789,11419,SOUTH RICHMOND HILL,NY,49193,24234,24959,1.13,43572
790,2780,TAUNTON,MA,49151,23657,25494,33.04,1488
791,92025,ESCONDIDO,CA,49110,24158,24952,22.04,2229
792,84120,WEST VALLEY CITY,UT,49107,24661,24446,10.17,4827
793,20902,SILVER SPRING,MD,49074,24293,24781,7.58,6473
794,90033,LOS ANGELES,CA,49049,24526,24523,3.27,15013
795,92024,ENCINITAS,CA,49048,24186,24862,16.88,2906
796,60435,JOLIET,IL,49002,23168,25834,10.71,4576
797,98023,FEDERAL WAY,WA,48964,24270,24694,10.32,4745
798,80020,BROOMFIELD,CO,48889,24313,24576,19.76,2475
799,78641,LEANDER,TX,48854,24589,24265,126.47,386
800,93638,MADERA,CA,48805,25526,23279,94.82,515
801,98632,LONGVIEW,WA,48786,23529,25257,129.13,378
802,53511,BELOIT,WI,48785,23156,25629,110.49,442
803,17601,LANCASTER,PA,48769,23130,25639,33.31,1464
804,91767,POMONA,CA,48768,24209,24559,5.62,8676
805,23455,VIRGINIA BEACH,VA,48765,24027,24738,16.12,3025
806,99336,KENNEWICK,WA,48749,24399,24350,13.35,3652
807,92692,MISSION VIEJO,CA,48739,23852,24887,9.85,4947
808,77080,HOUSTON,TX,48734,26191,22543,6.38,7635
809,92130,SAN DIEGO,CA,48721,23719,25002,18.44,2643
810,30032,DECATUR,GA,48693,23595,25098,13.63,3572
811,27705,DURHAM,NC,48684,24152,24532,43.88,1110
812,80504,LONGMONT,CO,48679,24538,24141,99.06,491
813,78741,AUSTIN,TX,48654,25745,22909,7.6,6404
814,38017,COLLIERVILLE,TN,48641,23157,25484,84.75,574
815,92064,POWAY,CA,48622,24115,24507,40.96,1187
816,75098,WYLIE,TX,48611,23753,24858,32.94,1476
817,48439,GRAND BLANC,MI,48594,23568,25026,52.91,918
818,90630,CYPRESS,CA,48590,23328,25262,6.13,7933
819,27407,GREENSBORO,NC,48545,23312,25233,30.29,1602
820,18103,ALLENTOWN,PA,48527,22619,25908,17.61,2756
821,90018,LOS ANGELES,CA,48498,23033,25465,2.9,16747
822,32068,MIDDLEBURG,FL,48490,23844,24646,101.09,480
823,21228,CATONSVILLE,MD,48483,22912,25571,15.5,3128
824,33016,HIALEAH,FL,48450,22904,25546,4.38,11067
825,11420,SOUTH OZONE PARK,NY,48449,23009,25440,2.08,23315
826,29485,SUMMERVILLE,SC,48443,23611,24832,35.72,1356
827,28601,HICKORY,NC,48428,22843,25585,46.05,1052
828,89030,NORTH LAS VEGAS,NV,48407,25242,23165,9.36,5173
829,97124,HILLSBORO,OR,48406,24167,24239,43.08,1124
830,76549,KILLEEN,TX,48388,24086,24302,76.64,631
831,97206,PORTLAND,OR,48384,24016,24368,6.53,7412
832,39503,GULFPORT,MS,48348,24335,24013,120.69,401
833,92879,CORONA,CA,48327,23580,24747,10.05,4811
834,78840,DEL RIO,TX,48325,24192,24133,951.46,51
835,42701,ELIZABETHTOWN,KY,48299,23226,25073,158.63,304
836,60637,CHICAGO,IL,48270,21262,27008,4.51,10715
837,95648,LINCOLN,CA,48243,23223,25020,141.51,341
838,60014,CRYSTAL LAKE,IL,48234,23744,24490,25.3,1906
839,80525,FORT COLLINS,CO,48207,23405,24802,24.24,1989
840,55044,LAKEVILLE,MN,48198,24050,24148,64.12,752
841,92243,EL CENTRO,CA,48190,23514,24676,110.28,437
842,93702,FRESNO,CA,48181,24334,23847,5.26,9153
843,28216,CHARLOTTE,NC,48172,22176,25996,29.9,1611
844,38109,MEMPHIS,TN,48169,22209,25960,67.31,716
845,33614,TAMPA,FL,48125,24147,23978,9.78,4922
846,23223,RICHMOND,VA,48111,22068,26043,16.85,2856
847,37122,MOUNT JULIET,TN,48107,23767,24340,111.94,430
848,48126,DEARBORN,MI,48100,23688,24412,9.8,4907
849,60123,ELGIN,IL,48053,24148,23905,13.77,3489
850,48187,CANTON,MI,48028,23459,24569,18.08,2657
851,94553,MARTINEZ,CA,48018,23882,24136,48.94,981
852,95616,DAVIS,CA,47995,22447,25548,27.56,1742
853,33810,LAKELAND,FL,47995,22966,25029,56.05,856
854,34787,WINTER GARDEN,FL,47990,23506,24484,68.95,696
855,10459,BRONX,NY,47977,22748,25229,0.82,58723
856,47150,NEW ALBANY,IN,47954,22920,25034,43.89,1093
857,85365,YUMA,AZ,47933,24687,23246,1368.69,35
858,59102,BILLINGS,MT,47930,22440,25490,14.78,3244
859,6606,BRIDGEPORT,CT,47916,23773,24143,5.29,9056
860,8302,BRIDGETON,NJ,47895,26318,21577,143.08,335
861,20176,LEESBURG,VA,47889,23618,24271,56.98,841
862,95207,STOCKTON,CA,47883,22139,25744,7.26,6599
863,91306,WINNETKA,CA,47879,24592,23287,4.14,11571
864,89074,HENDERSON,NV,47870,23451,24419,8.98,5333
865,58103,FARGO,ND,47859,23709,24150,11.31,4233
866,23434,SUFFOLK,VA,47846,22952,24894,203.4,235
867,10940,MIDDLETOWN,NY,47833,23795,24038,64.89,737
868,32703,APOPKA,FL,47824,23468,24356,50.76,942
869,48219,DETROIT,MI,47821,21550,26271,8.41,5688
870,94014,DALY CITY,CA,47818,23626,24192,6.31,7582
871,48185,WESTLAND,MI,47787,21592,26195,12.17,3928
872,92886,YORBA LINDA,CA,47786,23917,23869,14.73,3245
873,90032,LOS ANGELES,CA,47784,23412,24372,4.77,10024
874,19145,PHILADELPHIA,PA,47776,21735,26041,4.87,9816
875,85201,MESA,AZ,47737,24299,23438,9.32,5120
876,63366,O FALLON,MO,47697,23394,24303,68.75,694
877,1844,METHUEN,MA,47690,23305,24385,22.22,2146
878,1841,LAWRENCE,MA,47676,22854,24822,3.09,15434
879,94550,LIVERMORE,CA,47648,23510,24138,232.73,205
880,60644,CHICAGO,IL,47631,21654,25977,3.5,13593
881,98115,SEATTLE,WA,47611,23671,23940,6.58,7231
882,10950,MONROE,NY,47611,23476,24135,36.4,1308
883,32771,SANFORD,FL,47609,22630,24979,36.18,1316
884,75006,CARROLLTON,TX,47590,23495,24095,16.89,2818
885,18102,ALLENTOWN,PA,47576,22850,24726,3,15875
886,20171,HERNDON,VA,47565,23597,23968,12.1,3930
887,93611,CLOVIS,CA,47559,22931,24628,11.2,4248
888,6457,MIDDLETOWN,CT,47539,22705,24834,41.02,1159
889,95351,MODESTO,CA,47534,23786,23748,8.87,5359
890,90047,LOS ANGELES,CA,47533,21690,25843,4.73,10049
891,80011,AURORA,CO,47508,23770,23738,24.65,1927
892,48066,ROSEVILLE,MI,47499,23323,24176,9.85,4821
893,84604,PROVO,UT,47491,22847,24644,125.28,379
894,76051,GRAPEVINE,TX,47488,23071,24417,36.83,1289
895,95124,SAN JOSE,CA,47446,23859,23587,6.57,7222
896,7003,BLOOMFIELD,NJ,47442,22010,25432,5.29,8972
897,85022,PHOENIX,AZ,47433,23034,24399,9.36,5070
898,32304,TALLAHASSEE,FL,47417,24082,23335,15.67,3026
899,33021,HOLLYWOOD,FL,47400,22545,24855,8.71,5441
900,94568,DUBLIN,CA,47384,24102,23282,15.29,3100
901,90247,GARDENA,CA,47361,22118,25243,3.75,12616
902,20783,HYATTSVILLE,MD,47331,27089,20242,5.63,8408
903,8540,PRINCETON,NJ,47316,22724,24592,51.92,911
904,33126,MIAMI,FL,47311,22427,24884,5.01,9447
905,92028,FALLBROOK,CA,47282,23980,23302,94.37,501
906,92691,MISSION VIEJO,CA,47275,23035,24240,8.8,5370
907,85374,SURPRISE,AZ,47274,21846,25428,16.26,2907
908,90016,LOS ANGELES,CA,47273,21911,25362,3.63,13034
909,91765,DIAMOND BAR,CA,47273,22842,24431,18.92,2499
910,92111,SAN DIEGO,CA,47271,23830,23441,8.46,5588
911,63136,SAINT LOUIS,MO,47220,20429,26791,10.58,4463
912,92410,SAN BERNARDINO,CA,47192,23935,23257,8.22,5741
913,80918,COLORADO SPRINGS,CO,47189,23320,23869,11.98,3939
914,38654,OLIVE BRANCH,MS,47182,23213,23969,94.9,497
915,96720,HILO,HI,47109,23361,23748,299.53,157
916,83686,NAMPA,ID,47091,23009,24082,88.83,530
917,33029,HOLLYWOOD,FL,47086,23121,23965,17.83,2641
918,43229,COLUMBUS,OH,47084,22910,24174,8.81,5344
919,10451,BRONX,NY,47069,21045,26024,1.02,46373
920,78254,SAN ANTONIO,TX,47019,22713,24306,27.06,1738
921,98103,SEATTLE,WA,47019,23469,23550,4.64,10144
922,75093,PLANO,TX,46990,23218,23772,14.12,3328
923,33155,MIAMI,FL,46977,22902,24075,7.38,6365
924,80012,AURORA,CO,46974,23341,23633,7.77,6049
925,91748,ROWLAND HEIGHTS,CA,46966,23517,23449,14.47,3246
926,60645,CHICAGO,IL,46913,22546,24367,2.26,20776
927,33018,HIALEAH,FL,46903,22212,24691,19.49,2406
928,77511,ALVIN,TX,46889,23438,23451,158.52,296
929,27713,DURHAM,NC,46824,20987,25837,32.56,1438
930,8831,MONROE TOWNSHIP,NJ,46818,22136,24682,50.4,929
931,78155,SEGUIN,TX,46816,23050,23766,354.57,132
932,96792,WAIANAE,HI,46812,23010,23802,60.95,768
933,92084,VISTA,CA,46811,23311,23500,26.17,1789
934,90503,TORRANCE,CA,46780,22576,24204,5.3,8831
935,95843,ANTELOPE,CA,46775,22539,24236,6.45,7254
936,27360,THOMASVILLE,NC,46756,22661,24095,88.13,531
937,75023,PLANO,TX,46733,23308,23425,9.42,4961
938,19335,DOWNINGTOWN,PA,46691,23084,23607,42.53,1098
939,56001,MANKATO,MN,46689,23170,23519,114.54,408
940,95060,SANTA CRUZ,CA,46688,23590,23098,67.83,688
941,32174,ORMOND BEACH,FL,46686,22413,24273,123.42,378
942,32303,TALLAHASSEE,FL,46671,22617,24054,35.49,1315
943,27265,HIGH POINT,NC,46659,22152,24507,41.93,1113
944,27107,WINSTON SALEM,NC,46649,22565,24084,65.04,717
945,77070,HOUSTON,TX,46640,22977,23663,13.01,3584
946,29720,LANCASTER,SC,46633,22593,24040,283.69,164
947,20850,ROCKVILLE,MD,46629,21940,24689,14.1,3307
948,35215,BIRMINGHAM,AL,46629,21062,25567,28.67,1626
949,75074,PLANO,TX,46606,23803,22803,16.52,2822
950,97223,PORTLAND,OR,46574,23349,23225,11.55,4034
951,55303,ANOKA,MN,46557,23255,23302,63.1,738
952,8816,EAST BRUNSWICK,NJ,46550,22485,24065,20.54,2266
953,55304,ANDOVER,MN,46526,23893,22633,69.08,673
954,92069,SAN MARCOS,CA,46492,23033,23459,16.45,2826
955,78227,SAN ANTONIO,TX,46489,22563,23926,13.8,3368
956,76116,FORT WORTH,TX,46488,23057,23431,12.17,3821
957,95240,LODI,CA,46482,22834,23648,82.71,562
958,33319,FORT LAUDERDALE,FL,46473,20727,25746,6.96,6677
959,23185,WILLIAMSBURG,VA,46458,22267,24191,56.03,829
960,73013,EDMOND,OK,46457,22085,24372,29.28,1587
961,60126,ELMHURST,IL,46450,22851,23599,11.14,4171
962,28645,LENOIR,NC,46444,22658,23786,329.73,141
963,87507,SANTA FE,NM,46430,22645,23785,82.78,561
964,30157,DALLAS,GA,46413,22749,23664,84.94,546
965,98902,YAKIMA,WA,46412,23336,23076,9.03,5143
966,75060,IRVING,TX,46409,22894,23515,13.26,3500
967,98133,SEATTLE,WA,46405,22467,23938,7.1,6540
968,91790,WEST COVINA,CA,46404,21997,24407,5.77,8040
969,30064,MARIETTA,GA,46401,22398,24003,31.86,1456
970,60586,PLAINFIELD,IL,46395,22994,23401,17.52,2648
971,7052,WEST ORANGE,NJ,46386,22302,24084,12.06,3848
972,85283,TEMPE,AZ,46373,22610,23763,8.78,5282
973,48235,DETROIT,MI,46368,21321,25047,6.25,7418
974,47374,RICHMOND,IN,46361,22059,24302,117.42,395
975,94303,PALO ALTO,CA,46357,22760,23597,7.96,5822
976,91352,SUN VALLEY,CA,46334,22986,23348,11.67,3971
977,63303,SAINT CHARLES,MO,46318,22155,24163,19.85,2334
978,36695,MOBILE,AL,46316,22225,24091,47.75,970
979,93720,FRESNO,CA,46300,21755,24545,9.96,4650
980,27707,DURHAM,NC,46299,22083,24216,21.28,2176
981,65202,COLUMBIA,MO,46268,22457,23811,148.87,311
982,60115,DEKALB,IL,46267,22655,23612,80.76,573
983,43207,COLUMBUS,OH,46253,22683,23570,23.32,1984
984,98225,BELLINGHAM,WA,46251,22444,23807,12.55,3684
985,89122,LAS VEGAS,NV,46236,23149,23087,9.08,5094
986,44646,MASSILLON,OH,46219,22781,23438,28.89,1600
987,85037,PHOENIX,AZ,46208,24004,22204,8.19,5645
988,85207,MESA,AZ,46201,22342,23859,29.86,1547
989,75062,IRVING,TX,46200,22750,23450,10.99,4203
990,27603,RALEIGH,NC,46175,23611,22564,51.61,895
991,33612,TAMPA,FL,46167,22844,23323,10.22,4519
992,22304,ALEXANDRIA,VA,46148,21471,24677,4.63,9959
993,36116,MONTGOMERY,AL,46139,20823,25316,56.07,823
994,40214,LOUISVILLE,KY,46134,22595,23539,14.86,3105
995,33010,HIALEAH,FL,46108,22572,23536,4.32,10683
996,98270,MARYSVILLE,WA,46105,22910,23195,14.31,3222
997,95037,MORGAN HILL,CA,46100,22296,23804,243.32,189
998,27616,RALEIGH,NC,46074,22210,23864,22.22,2074
999,32839,ORLANDO,FL,46052,23823,22229,7.45,6178
1000,88101,CLOVIS,NM,46046,23560,22486,532.07,87
